111111111111111111111111
1101101110111101101111E1
100000000000000000000XX1
100100111001X01100100CC1
1P000000000000000X000CC1
111111111111111111111111