111111111111111111111111111111111111111111111111111111111111
1101101110111101101111E1110110111011110110111111011011111111
100000000000000000000000000000000000000000000000000000000001
100100111001001100100CC11001X0111001001100100CC1100100100011
100100111001001100100CC1100100111001001100100CC1100100100011
100100111001001100100CC1100100111001001100100CC1100100100011
100100111001001100100CC1100100111001001100100CC1100100100X11
100100111001001100100CC1100100111001001100100CC1100100100011
100100111001001100100CC1100100111001001100100CC1100100100011
100100111001001100100CC1100100111001001100100CC1100100100011
100100111001001100100CC1100100111001001100100CC1100100100011
100100111001001100100CC1100100111001001100100CC1100100100011
1001001110X1001100100CC110010X111001001100100CC1100100100011
100001000000000001000CC00000000000000100000CC100000000001CC1
100001000000010001000CC00000100000000100000CC100000000001CC1
100001000000010001000CC0000010000000X100000CC100000000001CC1
1P0001000000010001000CC0000010000000X100000CC100000000001CC1
100001000000010001000CC0000010000000X100000CC100000000001CC1
100001000000010001000CC0000010000000X100000CC000000000001CC1
10000100000001X001000CC0000010000000X100000CC100000000001CC1
100001000000010001000CC00000100000000000000CC100000000001CC1
100001000000010001000CC00000100000000100000CC100000000001CC1
100000000000010000000CC00000100000000100000CC100000000001CC1
111111111111111111111111111111111111111111111111111111111111