111111111111111111111111111111111111111111111111111111111111
1101101110111101101111E1110110111011110110111111011011111111
100000000000000000000000000000000000000000000000000000000001
100100111001001100100CC1100100111001001100100CC1100100100011
100100111001001100100CC1100100111001001100100CC1100100100011
100100111001001100100CC1100100111001001100100CC1100100100011
100100111001001100100CC1100100111001001100100CC1100100100011
100100111001001100100CC1100100111001001100100CC1100100100011
100100111001001100100CC1100100111001001100100CC1100100100011
100100111001001100100CC1100100111001001100100CC1100100100011
100100111001001100100CC1100100111001001100100CC1100100100011
100100111001001100100CC1100100111001001100100CC1100100100011
100100111001001100100CC1100100111001001100100CC1100100100011
100000000000000000000CC00000000000000000000CC100000000000CC1
100000000000000000000CC00000000000000000000CC100000000000CC1
100000000000000000000CC00000000000000000000CC100000000000CC1
1P0000000000000000000CC00000000000000000000CC100000000000CC1
100000000000000000000CC00000000000000000000CC100000000000CC1
100000000000000000000CC00000000000000000000CC100000000000CC1
100000000000000000000CC00000000000000000000CC100000000000CC1
100000000000000000000CC00000000000000000000CC100000000000CC1
100000000000000000000CC00000000000000000000CC100000000000CC1
100000000000000000000CC00000000000000000000CC100000000000CC1
111111111111111111111111111111111111111111111111111111111111