111111
1P0C01
100101
1C1EL1
111111