111111
1P0C01
100101
1C1E01
111111