111111
1P1C01
110101
1C1EL1
111111