111111
1PCCC1
1CC1C1
1C1EC1
111111